12 16
0 0 0 0 4 4 4 0 4 0 0 0 0 0 0 0
0 0 0 0 4 2 0 0 0 4 0 0 0 0 0 0
0 0 0 4 2 0 0 0 0 4 0 0 0 0 0 0
0 0 0 4 2 0 0 0 0 0 4 0 0 0 0 0
0 0 0 0 4 4 0 0 0 0 0 4 0 0 0 0
0 0 0 0 0 4 0 0 0 0 0 0 4 4 4 0
4 4 4 4 4 0 0 0 0 0 0 0 0 0 0 4
6 6 6 6 6 6 6 7 6 6 6 6 6 6 6 6
4 4 4 4 4 4 2 2 0 0 3 4 4 4 4 4
0 0 0 0 0 0 4 2 0 0 3 4 0 0 0 0
0 0 0 0 0 0 4 0 3 4 4 0 0 0 0 0
0 0 0 0 0 0 4 0 4 0 0 0 0 0 0 0

2 3 (5, 13)
2 3 (6, 5)
2 3 (10, 6)
1 2 (10, 13)
1 2 (10, 15)
1 2 (12, 15)
1 2 (12, 13)
