12 16
0 0 0 0 0 0 0 0 0 0 0 0 0 0 0 0
0 3 3 3 3 3 3 3 3 3 3 3 3 3 3 0
0 3 0 0 0 0 0 0 0 0 0 0 0 0 3 0
0 3 0 0 0 2 2 2 2 2 2 0 0 0 3 0
0 3 0 0 0 2 4 2 2 4 2 0 0 0 3 0
0 3 0 0 0 2 2 8 8 2 2 0 0 0 3 0
0 3 0 0 0 2 2 8 8 2 2 0 0 0 3 0
0 3 0 0 0 2 4 2 2 4 2 0 0 0 3 0
0 3 0 0 0 2 2 2 2 2 2 0 0 0 3 0
0 3 0 0 0 0 0 0 0 0 0 0 0 0 3 0
0 3 3 3 3 3 3 3 3 3 3 3 3 3 3 0
0 0 0 0 0 0 0 0 0 0 0 0 0 0 0 0

1 2 (5, 4)
1 2 (6, 4)
1 2 (7, 4)
1 2 (8, 4)
1 1 (6, 3)
1 1 (7, 3)
1 3 (5, 2)
1 3 (8, 2)
2 2 (5, 13)
2 2 (6, 13)
2 2 (7, 13)
2 2 (8, 13)
2 1 (6, 14)
2 1 (7, 14)
2 3 (5, 15)
2 3 (8, 15)
