12 16
0 0 0 0 0 0 0 0 5 0 0 0 0 0 0 0
0 0 0 0 0 0 0 0 5 0 0 0 0 3 3 3
0 0 0 0 0 4 0 0 1 0 0 0 4 3 2 3
0 0 3 3 3 4 4 0 5 0 0 4 4 2 2 3
0 0 3 2 3 3 4 0 5 0 4 4 3 2 3 3
0 0 3 2 2 2 4 0 5 0 4 3 3 3 3 2
0 0 3 3 2 2 3 0 1 0 3 2 3 3 3 3
0 0 0 3 2 3 3 3 5 0 3 2 3 3 3 3
0 3 3 3 0 3 2 3 5 0 3 3 3 3 3 3
3 3 2 3 0 3 3 4 5 0 0 4 3 3 2 3
3 2 2 3 0 0 0 0 5 0 0 4 3 2 2 2
3 3 3 3 0 0 0 0 5 0 0 0 4 3 2 2
