12 16
3 3 3 3 3 3 3 3 8 3 3 3 3 3 3 3
3 3 3 3 3 3 3 3 8 3 3 3 3 6 6 6
3 3 3 3 3 7 3 3 4 3 3 3 7 6 5 6
3 3 6 6 6 7 7 3 8 3 3 7 7 5 5 6
3 3 6 5 6 6 7 3 8 3 7 7 6 5 6 6
3 3 6 5 5 5 7 3 8 3 7 6 6 6 6 5
3 3 6 6 5 5 6 3 4 3 6 5 6 6 6 6
3 3 3 6 5 6 6 6 8 3 6 5 6 6 6 6
3 6 6 6 3 6 5 6 8 3 6 6 6 6 6 6
6 6 5 6 3 6 6 7 8 3 3 7 6 6 5 6
6 5 5 6 3 3 3 3 8 3 3 7 6 5 5 5
6 6 6 6 3 3 3 3 8 3 3 3 7 6 5 5
