12 16
2 4 4 2 4 4 4 4 4 0 0 0 0 0 0 0
2 4 2 4 3 4 2 4 3 0 0 0 0 0 0 0
3 4 0 5 4 2 3 2 0 0 0 0 0 4 0 0
4 0 0 5 3 3 2 2 0 0 0 0 0 0 0 0
2 4 0 5 2 2 2 2 0 4 4 0 0 0 0 0
2 4 0 5 2 2 2 3 0 4 4 0 0 0 0 0
4 3 2 5 3 3 0 0 0 5 0 0 0 0 0 0
4 0 0 5 2 2 0 0 0 5 3 2 0 0 0 0
4 4 0 5 2 3 0 0 0 5 3 3 0 0 0 0
3 2 4 5 2 3 0 0 0 1 2 0 0 0 0 0
2 2 4 5 0 0 0 0 0 5 2 0 0 0 0 0
3 3 4 5 0 0 0 0 0 5 0 0 0 0 0 0

2 1 (2, 2)
2 1 (1, 3)
2 1 (2, 4)
2 1 (1, 5)
1 2 (10, 10)
1 3 (9, 11)
1 1 (11, 11)
