12 16
0 0 0 0 4 4 4 0 4 0 0 0 0 0 0 0
0 0 0 0 4 2 0 0 0 4 0 0 0 0 0 0
0 0 0 4 2 0 0 0 0 4 0 0 0 0 0 0
0 0 0 4 2 0 0 0 0 0 4 0 0 0 0 0
0 0 0 0 4 4 0 0 0 0 0 4 0 0 0 0
0 0 0 0 0 4 0 0 0 0 0 0 4 4 4 0
4 4 4 4 4 0 0 0 0 0 0 0 0 0 0 4
6 6 6 6 6 6 6 7 6 6 6 6 6 6 6 6
4 4 4 4 4 4 2 2 0 0 3 4 4 4 4 4
0 0 0 0 0 0 4 2 0 0 3 4 0 0 0 0
0 0 0 0 0 0 4 0 3 4 4 0 0 0 0 0
0 0 0 0 0 0 4 0 4 0 0 0 0 0 0 0

1 3 (5, 13)
1 3 (6, 5)
1 3 (10, 6)
2 2 (10, 13)
2 2 (10, 15)
2 2 (12, 15)
2 2 (12, 13)
